NO ./textures/TECH_3D.xpm
SO ./textures/TECH_3G.xpm
EA ./textures/TECH_4F.xpm
WE ./textures/TECH_3I.xpm

F 1,56,131
C 230,25,120

        1111111111111111111111111 
        1000000000110000000000001
        1011000001110000000000001
        1001000000000000000000001

111111111011000001110000000000001
100000000011000001110111111111111
11110111111111000000000010001
11110111111111011101010000001
11000000110101011100000010001
10000000000000001100000010001
10000000000000001101010010001
11000001110101011111011110N1111
11110111 1110101 101111010001
11111111 1111111 111111111111
