NO ./textures/TECH_3D.xpm
SO ./textures/TECH_3G.xpm
WE ./textures/TECH_3I.xpm

F 220,100,0
C 225,30,200

111111111
1000N0001
100000001
100000001
111111111
