NO ./textures/TECH_3D.xpm
SO ./textures/TECH_3G.xpm
WE ./textures/TECH_3I.xpm
EA ./textures/TECH_4F.xpm

F 0,0,0
C 255,255,255

   111111111111
111100000011
101100000111
100100N00001
100000000001
111111111111
